











C 40,42,4    2
F 14 ,1       7 ,      14

EA         ./textures/42_EA.xpm
NO                                                     ./textures/42_NO.xpm
SO ./textures/42_SO.xpm
WE ./textures/42_WE.xpm 


11111111111111011111111111111
10000000001100000000000000001
10110000011100000000000010001
10010000000000000000000010001
10110000011100000000000010001
10000000001100000111011110001
11110111111111011100000010001
11110111111111011100000010001
11000000110101011100000010001
10000000000000001100000010001
10000000000000001100000000001
11000000110101000000000000001
11110111110101000000000000001
10000000001100000100000010001
10000000000000000000000001001
10000000001000010000000001001
10000000001101000000N00000001
10000000000100000000000000001
11111111111111111111111111111