F 0, 128, 0 
C 105,105,105


NO ./textures/tile_North.xpm
EA ./textures/tile_East.xpm
SO ./textures/tile_South.xpm
WE ./textures/tile_West.xpm

111111111111111111111111111111111
     1111000000000110000000000001
1111111110110000011100000000011111111111
111111111001000000000000001111001
111111111011000001110000000000001
100000000011000001110111111111111
11110111111111011100000010001
11110111111111011101010000001
11000000110101011100000010001
10000000000000001100000010001
10000000000000000001010010001
11000001110101011111011110N011
11110111 1110101 101111010001
11111111 1111111 111111111111
