F 0, 128, 0 
C 105,105,105


NO ./textures/tile_North.xpm
EA ./textures/tile_East.xpm
SO ./textures/tile_South.xpm
WE ./textures/tile_West.xpm

111111111111111111111111111111111
    11111000000000110000000000001
1111111110000000011100000000011111111111
111111100000000000000111111111
11111111100000000000001111
1111111111000000000111111111111
         11110000111111110111
11111111111111011101010000001
11000000110101011100000010001
1000000000000000110000001000111111
1000000000000000000000001000000001
11000001110101011111011110N0111111
11110111 1110101 101111010001
11111111 1111111 111111111111
