F 0, 128, 0 
C 105,105,105


NO ./textures/tile_North.xpm
EA ./textures/tile_East.xpm
SO ./textures/tile_South.xpm
WE ./textures/tile_West.xpm

1111111111111111111111111111111
    110000000000110000000000001
1111110000000001110000000001111
110000000000000000000111111111
11000000000000000001111
111111111100000000011111111
         110000000000001011
1111111111100000000000000111
11000000000000000000000000011
1000000000000000000000000000111111
1000000000000000000000000000000001
10000001110000011100011110N0111111
10000001 1000001 100000000001
11111111 1111111 111111111111
