F 0, 128, 0 
C 105,105,105


NO ./textures/tile_North.xpm
EA ./textures/tile_East.xpm
SO ./textures/tile_South.xpm
WE ./textures/tile_West.xpm

1111111111111111111111111111111
 10000000000000000000000000001
  100000000000000000000000001
   1000000000000000000000001
    10000000000000000000001
     100000000000000000001
      1000000000000000001
       10000000000000001
       10000000000000001
       10000000000000001
      1000000000000000001
     100000000000000000001
    10000000000000000000001
   1000000000000000000000001
  100000000000000000000000001
 100000000000000N0000000000001
1111111111111111111111111111111