F 0, 128, 0 
C 105,105,105


NO ./textures/tile_North.xpm
EA ./textures/tile_East.xpm
SO ./textures/tile_South.xpm
WE ./textures/tile_West.xpm

111111111111       111111111111
 10000000001       10000000001
  1000000001       1000000001
   100000001       100000001
    10000001       10000001
     100000111111111000001
      1000000000000000001
       10000000000000001
       10000000N00000001
       10000000000000001
      1000000000000000001
     100000111111111000001
    10000001       10000001
   100000001       100000001
  1000000001       1000000001
 10000000001       10000000001
111111111111       111111111111