F 0, 128, 0 
C 105,105,105


NO ./textures/tile_North.xpm
EA ./textures/tile_East.xpm
SO ./textures/tile_South.xpm
WE ./textures/tile_West.xpm

111111111111111111111111111111111
100000000000000000000000000000001
100000000000000000000000000000001
100000000000000000000000000000001
100000011111111111111111110000001
100000011111111111111111110000001
100000011111111111111111110000001
100000011111111111111111110000001
100000000000000000000000000000001
100N00000000000000000000000000001
100000000000000000000000000000001
111111111111111111111111111111111