F 0, 128, 0 
C 105,105,105


NO ./textures/tile_North.xpm
EA ./textures/tile_East.xpm
SO ./textures/tile_South.xpm
WE ./textures/tile_West.xpm

11111
10011
1S001
11111
