
NO ./textures/title.xpm
EA ./textures/purple_block.xpm
SO ./textures/wall1_e.xpm
WE ./textures/blue_block.xpm

C 0, 255, 34    
F 255, 0, 255 


11111111111111111111111111111111111
10000000000000000000000000000000001
10000000000000000000000000000000011
10000000001000000000000000100000001
10000000001000000000000000100000001
10000000000000000000000000000000001
100000000010000000000000001000 0001
10000000000000000000000000100000001
10000000001000000000000000000000001
10000000000000000000000000100000001
10000000001000000000000000100000001
100000000000000000000S0000000000001
10000000001000000000000000100000001
10000000000000000000000000000000001
10000000000000000000000000000000001
10000000000000000000000000000000001
11111111111111111111111111111111112