


C 40,42,4    2
F 14 ,1       7 ,      14

EA         ./textures/42_EA.xpm
NO                                                     ./textures/42_NO.xpm
SO ./textures/42_SO.xpm
WE ./textures/42_WE.xpm 


111111111111111111111111111
100000000011000000000000001
101100000111000000000010001
100100000000000000000010001
101100000111000000000010001
100000000011000001111110001
111101111111110111000010001
111101111111110111010010001
110000001101010111000010001
100000N00000000011000010001
100000000000000011000000001
110000001101010000000000001
111101111101010000000000001
100000000011000001000010001
100000000000000010000001001
100000000010000100000001001
100000000011010000000000001
100000000001000000010000001
111111111111111111111111111