F 255, 0, 255 
C 0, 255,                             255


NO ./textures/red_block.xpm
EA ./textures/brick_block.xpm
SO ./textures/wall1_e.xpm
WE ./textures/blue_block.xpm

11111
10011
1S001
11111
